#######??????####################################
#...............................................#                                            
#...............................................#
#..............................######...........#
#...............................................#
#...............................................#
#....########...................................#
#...............................................#
#...............................................#
#...............................................#
#.............................##########........#
#...............................................#
#...............................................#
#.....######..........####......................#
#.....................####......................#
#...............................................#
#...............................................#
#..............................######...........#
#...............................................#
#...............................................#
#.................#####.........................#
#...............................................#
#...............................................#
#...............................................#
#...............................................#
#...............................................#
#...............................................#
#...................###...###...................#
#...................#...@...#...................#
#...................#.......#...................#
#################################################