#######################?#########################
#...............................................#
#....................x..........................#
#...............................................#
##########..........##########..................#
#...............................................#
############.....################...#############
###########.....##################...############
#########......#######......#######......########
#########......#######......#######......########
#########................................########
#########..x.............................########
#########......####.........#######..........####
###################.........################.####
#################......####...##############.####
#################.....######...#############.####
###############.....#########...###########...###
#############......###########...##########.+.###
###########......##############...#########...###
###########.....################...##############
########.......##################.......#########
########.......##################.......#########
########..x....##################...xa...#########
########.......##################.......#########
########.......##################.......#########
########.......##################.......#########
########................................#########
#############......................##############
#####################......######################
#####################...@..######################
#####################......######################