##########?######################################
#...............................................#                                            
#...............................................#
#..............................######...........#
#...............................................#
#...............................................#
#....########...................................#
#...............................................#
#...............................................#
#...............................................#
#.............................##########........#
#.......x.......................................#
#...............................................#
#.....######..........####...............x......#
#.....................####......................#
#...............................................#
#...............................................#
#..............................######...........#
#...............................................#
#...............................................#
#.................#####.........................#
#...............................................#
#...............................................#
#...............................................#
#....x..........................+...............#
#...............................................#
#...............................................#
#...................###...###.............x.....#
#...................#...@...#...................#
#...................#.......#...................#
#################################################